00000000000000000000000000000000
01111111111111111111111111111110
01111111111111111111111111111110
01111000000011111111111111111110
01111111111111111111111111111110
00001111111111111111111111111110
01111111111111111111111111111110
01100001111111111111111111111110
01111111111111111111111111111110
01111111000001101111111111111110
01111111111111101111111111111110
00000000000000000000000000000000
